SSSSSSSSSSSSSSSSSSSSSSSSSSSSSSSSSSS
SSSSSS                       SSSSSS
SSSS             P             SSSS
SS                               SS
S P                             P S
S                                 S
S                                 S
SSSSSSS                     SSSSSSS
SSSSS    SSS           SSS    SSSSS
SSSS           SSSSS           SSSS
SS            SSSSSSS            SS
S          SSSSS   SSSSS          S
S 1        SSS   P   SSS        2 S
S      SSSSSS         SSSSSS      S
SSS                             SSS
SSS                             SSS
SSSSSS                       SSSSSS
SSSSSSSSSSSSSSSSSSSSSSSSSSSSSSSSSSS
