SSSSSSSSSSSSSSSSSSSSSSSSSSSSSSSSSSS
SSSSSSSSS         SSSSSSS        SS
SSSS                           P  S
SS                                S
S     P                           S
S           SSSSS          SSSSSSSS
S            SSS           SSSSSSSS
S   SSSSS                    SSSSSS
S    SSS                        SSS
S                             P  SS
S                 SSSSS   2       S
S 1              SSSSS            S
S                        SSSSSSSSSS
SSSSSS     SSSS             SSSSSSS
SSS P      SSSS               SSSSS
SSS       SSSSSS                SSS
SSS      SSSSSSSS     SSSS      SSS
SSSSSSSSSSSSSSSSSSSSSSSSSSSSSSSSSSS
