0
33333333333333333333333333333333333
33333300000000000000000000000333333
33330000000000000500000000000003333
33000000000000000000000000000000033
30500000000000000000000000000000503
30000000000000000000000000000000003
30000000000000000000000000000000003
33333330000000000000000000003333333
33333000033300000000000333000033333
33330000000000033333000000000003333
33000000000000333333300000000000033
30000000000333330003333300000000003
30100000000333000500033300000000203
30000003333330000000003333330000003
33300000000000000000000000000000333
33300000000000000000000000000000333
33333300000000000000000000000333333
33333333333333333333333333333333333
