S                P                S
S                                 S
S P          SSSSSSSSS          P S
S               SSS               S
S         SS     S     SS         S
SSSS                           SSSS
SSSSSSSS                   SSSSSSSS
SSSSSSS  SSSS         SSSS  SSSSSSS
SSSSS           SSS          SSSSSS
SSS             SSS           SSSSS
S            SSSSPSSSS          SSS
S 1        SSSSS   SSSSS          S
S     SSS  SSSS     SSSS         2S
SSS                       SSS     S
SSSS                             SS
SSSSS                          SSSS
SSSSSSSSSSSSSSSSSSSSSSSSSSSSSSSSSSS
SSSSSSSSSSSSSSSSSSSSSSSSSSSSSSSSSSS
