0
33333300000000000000000000000003333
33300000000500000000000000000000333
30000000000000000000000000000000003
30000000000000000000000000000000003
30003333300000000000333000003300503
30003333333000000333330000033330003
30000033333330000033300000333330003
30000000033333300000000033333330003
30000000000000000000000000033330003
33010000000000003333330000003300003
33000000033333333333333300000000003
33330000333333333333333330000000033
33333003333333333333333333300020033
33333000000333333333333333330000333
33333300000000000000000000000033333
33333300000000000000000000000033333
33333333300000000000000000033333333
33333333333333333333333333333333333
