S                                 S
S                                 S
S                                 S
S                                 S
S                                 S
S                              SSSS
S                            1 SSSS
S                              SSSS
SSSSS                        SSSSSS
SSSSS 2                      SSSSSS
SSSSSS                     SSSSSSSS
SSSSSSSS                   SSSSSSSS
SSSSSSSSSS                 SSSSSSSS
SSSSSSSSSSSSSSSSS        SSSSSSSSSS
SSSSSSSSSSSSSSSSSSS    SSSSSSSSSSSS
SSSSSSSSSSSSSSSSSSSSSSSSSSSSSSSSSSS
SSSSSSSSSSSSSSSSSSSSSSSSSSSSSSSSSSS
SSSSSSSSSSSSSSSSSSSSSSSSSSSSSSSSSSS
