0
33333333333333333333003333333333333
33300000000333333000000000000003333
33000000000033300000000000000000333
33000000000000000000000000000000033
33003333300000000003333000003300003
33003333330000000333330000033330003
30000033333333000033300000333330003
30000000003333300000000033333330003
30000000000000000000000000033330003
33010000000000003333330000003300003
33000000033333333333333300000000003
33330000333333333333333330000000003
33333003333333333333333333300020033
33333000000333333333333333330000333
33333300000000000000000000000033333
33333300000000000000000000000033333
33333333300000000000000000033333333
33333333333333333333333333333333333
