SSSSSS                         SSSS
SSS        P                    SSS
S                                 S
S                                 S
S   SSSSS           SSS     SS  P S
S   SSSSSSS      SSSSS     SSSS   S
S     SSSSSSS     SSS     SSSSS   S
S        SSSSSS         SSSSSSS   S
S                          SSSS   S
SS 1            SSSSSS      SS    S
SS       SSSSSSSSSSSSSSS          S
SSSS    SSSSSSSSSSSSSSSSS        SS
SSSSS  SSSSSSSSSSSSSSSSSSSS   2  SS
SSSSS      SSSSSSSSSSSSSSSSS    SSS
SSSSSS                        SSSSS
SSSSSS                        SSSSS
SSSSSSSSS                  SSSSSSSS
SSSSSSSSSSSSSSSSSSSSSSSSSSSSSSSSSSS
