SS                                 
SS                                 
SS                                 
SS                                 
SS                                 
SS                               SS
SS                               SS
SS                               SS
SS                           P  PSS
SS                               SS
SS1                              SS
SS                               SS
SSS                             SSS
SSS                             SSS
SSS             2              SSSS
SSSSSSSSSSSSSSS  SSSSSSSSSSSSSSSSSS
SSSSSSSSSSSSSSSSSSSSSSSSSSSSSSSSSSS
SSSSSSSSSSSSSSSSSSSSSSSSSSSSSSSSSSS
