SSSSSSSSSSSSSSSSSSSS  SSSSSSSSSSSSS
SSS        SSSSSS              SSSS
SS          SSS                 SSS
SS                               SS
SS  SSSSS          SSSS     SS    S
SS  SSSSSS       SSSSS     SSSS   S
S     SSSSSSSS    SSS     SSSSS   S
S         SSSSS         SSSSSSS   S
S                          SSSS   S
SS 1            SSSSSS      SS    S
SS       SSSSSSSSSSSSSSS          S
SSSS    SSSSSSSSSSSSSSSSS         S
SSSSS  SSSSSSSSSSSSSSSSSSSS   2  SS
SSSSS      SSSSSSSSSSSSSSSSS    SSS
SSSSSS                        SSSSS
SSSSSS                        SSSSS
SSSSSSSSS                  SSSSSSSS
SSSSSSSSSSSSSSSSSSSSSSSSSSSSSSSSSSS
