0
33330000050000000000003333333333333
33300000000000000000000000000003333
33000000000000000000000000000000333
30000033333333330000000000000000033
30000003333330000000000000333300003
30100000333000000000000000003330003
33000000000000000003333000020330003
33330000000000000333333330000330503
33333300000000333333333333333330003
33333300000000000003333333333330003
33330000333000000000033300000000003
33000000000000000000000000000000003
30000000000003333300000000033330003
30000000000000000000000000000000003
30000333330000000000033300000000003
33005033333300000003333333000000003
33300033333300000033333333330000003
33333333333333333333333333333333333
