S                P                S
S                                 S
S P           SSSSSSS           P S
S            SS     SS            S
S         SSSS       SSSS   2     S
SSSS                           SSSS
SSSSSSSS                   SSSSSSSS
SSSSSSS  SSSS          SSS  SSSSSSS
SSSSS           SSS          SSSSSS
SSS             SSS           SSSSS
S            SSSSSSSSS          SSS
S 1        SSSSSSPSSSSSS          S
S     SSS  SSSSS   SSSSS          S
SSS                       SSS     S
SSSS                             SS
SSSSS                          SSSS
SSSSSSSSSSSSSSSSSSSSSSSSSSSSSSSSSSS
SSSSSSSSSSSSSSSSSSSSSSSSSSSSSSSSSSS
