1
30000000000000000500000000000000003
30000000000000000000000000000000003
30500000000003333333330000000000503
30000000000000003330000000000000003
30000000003300000300000330000000003
33330000000000000000000000000003333
33333333000000000000000000033333333
33333330033330000000003333003333333
33333000000000003330000000000333333
33300000000000003330000000000033333
30000000000003333533330000000000333
30100000000333330003333300000000003
30000033300333300000333300000000023
33300000000000000000000000333000003
33330000000000000000000000000000033
33333000000000000000000000000003333
33333333333333333333333333333333333
33333333333333333333333333333333333
