1
33333000000000000000000000003333333
33330000000000000000000000000003333
33000000000000000000050000000000033
30000000000000000000000000000000003
30001000333300000000000000000000003
30000000000000000000000000000000023
33333300000000000000000000000000003
33333300000000000003333300000033333
33333333300003333000000000000333333
33333333300000000000000000003333333
30003333333300000000000000333333333
30500003333300000000000033333000003
30000000000000000000000000000005003
30000000000000000003300000000000003
30000000000000000333300000000000003
33300000000000000333333300000000333
33333330000000033333333330000333333
33333333333333333333333333333333333
