  P                                
                                   
                                   
SSSSSSSS                           
SSSSSSSS   SS                      
SSSSSS   P SSSS                  2 
SSS        SSSSSS     SSSSSSS      
SSS         SSSSS                SS
S           SSSSSSS              SS
                            SSSSSSS
                            SSSSSSS
S                        SSSSSSSSSS
SS    SSSSSSS       SSS  SSSSSSSSSS
SS                       SSSSSSSSSS
SS 1                     SSSSSSSSSS
SS            SSSSSSSSSSSSSSSSSSSSS
SSSSSSSSSSSSSSSSSSSSSSSSSSSSSSSSSSS
SSSSSSSSSSSSSSSSSSSSSSSSSSSSSSSSSSS
