SSSSSSSSSSSSSSSSSSSSSSSSSSSSSSSSSSS
SSSSSSSSS         SSSSSSS        SS
SSSS                           P  S
SS                                S
S     P                           S
S           SSSSS          SSSSSSSS
S            SSS           SSSSSSSS
S   SSSSS                    SSSSSS
S    SSS                        SSS
S                  SSSSS         SS
SS                  SSS   2       S
S 1                               S
S                        SSSS     S
SSSSS      SSSS           SS      S
SSSSS      SSSS               SSSSS
S P       SSSSSS                P S
SS       SSSSSSSS     SSSS        S
SSSSSSSSSSSSSSSSSSSSSSSSSSSSSSSSSSS
