2
44444444444444444444444444444444444
44444444400000000044444440000000044
44440000000000000000000000000005004
44000000000000000000000000000000004
40000050000000000000000000000000004
40000000000044444000000000044444444
40000000000004440000000000044444444
40004444400000000000000000000444444
40000444000000000000000000000000444
40000000000000000000000000000050044
40000000000000000044444000200000004
40100000000000000444440000000000004
40000000000000000000000004444444444
44444400000444400000000000004444444
44405000000444400000000000000044444
44400000004444440000000000000000444
44400000044444444000004444000000444
44444444444444444444444444444444444
