2
44444444444444444444444444444444444
44444444400000000044444440000000044
44440000000000000000000000000005004
44000000000000000000000000000000004
40000050000000000000000000000000004
40000000000044444000000000044444444
40000000000004440000000000044444444
40004444400000000000000000000444444
40000444000000000000000000000000444
40000000000000000004444400000000044
40000000000000000000444000200000004
40100000000000000000000000000000004
40000000000000000000000004444000004
44444000000444400000000000440000004
44444000000444400000000000000044444
44500000004444440000000000000000504
44000000044444444000004444000000004
44444444444444444444444444444444444
