SSSSSSSSSSSSSSSSSSSSSSSSSSSSSSSS
S                  1           S
S            SSSS              S
S                              S
S                LLL     SS    S
S                        SSS   S
S                            SSS
S                  LLLS    SSSSS
SSSSSSSSSSSSS             SSSSSS
SSSSSSSSSSSSSSS          SSSSSSS
SSSSSS                  SSSSSSSS
SSSSSSSSSSSSSSS      SSSSSSSSSSS
SSSSSSSSSSSSSSSSS    SSS  SSSSSS
SSSSSSSSS         SSSSSS  SSSSSS
SSSSSS SSSSS      SSSSSSSSSSSSSS
SSSSS            SSSSSS    SSSSS
SSSSSSSSSSSSSSSSSSSSSSSSSSSSSSSS
SSSSSSSSSSSSSSSSSSSSSSSSSSSSSSSS