                                   
                                   
                              SSSSS
                     1     SSSSSSSS
SSSS                     SSSSSSSSSS
SSSSSS                  SSSSSSSSSSS
SSSSSSSS             SSSSSSSSSSSSSS
SSSS SSSSSS  SSSSSSSSSSSSSSSSSSSSSS
SS     SSSSSSSSSSSSSSSSSSSSSSSSSSSS
SS     SSSSSSSSS   SSSSSSSSSSSSSSSS
S S        SS     SSSSSSSSSSSSSSSSS
S S           S SSSS SSSSSSSSSSSSSS
S S                 SSSSSSSSSSSSSSS
SSSSS S            SSSSSSSSSSSSSSSS
SS     SSSSSSS SSSSSS   S  SSSSSSSS
SS                S   SS  SSSSSSSSS
SS       SSS SSSSSSSS  S SSSSSSSSSS
SS SSSSSS                   SSSSSSS
