SSSSSSSSSSSSSSSSSSSSSSSSSSSSSSSSSS
S                  1             S
S            SSSS                S
S                           S    S
S                LLL       SS    S
S                          SSS   S
S                              SSS
S                   LLLLS    SSSSS
SSSSSSSSSSSSS               SSSSSS
SSSSSSSSSSSSSSS            SSSSSSS
SSSSSS                    SSSSSSSS
SSSSSSSSSSSSSSSSS      SSSSSSSSSSS
SSSSSSSSSSSSSSSSSSS    SSS  SSSSSS
SSSSSSSSSSS         SSSSSS  SSSSSS
SSSSSSSS SSSSS      SSSSSSSSSSSSSS
SSSSSSS            SSSSSS    SSSSS
SSSSSSSSSSSSSSSSSSSSSSSSSSSSSSSSSS