SSSSSSSSSSSSSSSSSSSSSSSSSSSSSSSSSS
S              1                 S
S       SSS  PPPP              SSS
S                            SSSSS
S    SSSSSS      LLL       SSSSSSS
S  S S  S                SSSSSSSSS
S                      SSSSSSSSSSS
S                    SSSSSSSSSSSSS
SSSSSSSSSSSSS      SSSSSSSLLLSSSSS
SSSSSSSSSSSSSSS  SSSSSSSSSSSSSSSSS
SSSSSS                 SSSSSSSSSSS
SSSSSSSSSSSSSSSSS SSSSSSSSSSSSSSSS
SSSSSSSSSSSSSSSSS  SS  SS   SSSSSS
SSSSSSSSSSS         SSSSSSS  SSSSS
SSSSSSSS SSSSS      SSSSSSSSSSSSSS
SSSSSSS            SSSSSS    SSSSS
SSSSSSSLLLLLLLLLLLLSSSSSSSSSSSSSSS